version 1
size 56 125
spawn 0.5 7.5
tiles
2 1 1 1 2 2 2 2 1 1 2 2 2 2 2 2 2 1 1 1 1 1 1 2 2 2 2 2 2 2 1 2 2 2 2 2 2 2 2 2 2 2 2 2 2 2 2 2 2 2 2 2 2 2 2 2 2 2 2 2 2 2 2 2 2 2 2 1 1 1 1 1 1 1 2 0 0 0 0 0 0 0 0 0 0 0 0 0 0 0 0 0 0 0 0 0 0 0 0 0 0 0 0 0 0 0 0 0 0 0 0 0 0 0 0 0 0 0 0 0 0 0 0 0 0
2 0 0 0 2 2 2 2 2 2 2 0 0 0 0 0 2 0 0 0 0 0 0 2 2 2 2 2 2 2 0 0 0 0 0 0 0 0 0 0 0 0 0 0 0 0 0 2 2 2 2 0 0 0 0 2 2 2 2 2 2 2 2 2 2 2 1 0 0 0 0 0 0 0 2 0 0 0 0 0 0 0 0 0 0 0 0 0 0 0 0 0 0 0 0 0 0 0 0 0 0 0 0 0 0 0 0 0 0 0 0 0 0 0 0 0 0 0 0 0 0 0 0 0 0
2 0 0 0 1 1 1 1 0 0 2 0 0 0 0 0 2 0 0 0 0 0 0 2 2 2 0 0 0 2 0 0 0 0 0 0 0 0 0 0 0 0 0 0 0 0 0 2 2 2 2 0 0 0 0 1 0 0 0 0 2 2 0 0 0 1 0 0 0 0 0 0 0 0 2 0 0 0 0 0 0 0 0 0 0 0 0 0 0 0 0 0 0 0 0 0 0 0 0 0 0 0 0 0 0 0 0 0 0 0 0 0 0 0 0 0 0 0 0 0 0 0 0 0 0
2 0 0 0 0 0 0 0 0 0 2 2 0 0 0 2 2 0 0 0 0 0 0 2 2 2 0 0 0 2 0 0 0 0 0 0 0 0 0 0 0 0 0 1 0 0 0 2 2 2 2 0 0 0 0 0 0 0 0 0 2 2 0 0 0 0 0 0 0 0 0 0 0 0 2 0 0 0 0 0 0 0 0 0 0 0 0 0 0 0 0 0 0 0 0 0 0 0 0 0 0 0 0 0 0 0 0 0 0 0 0 0 0 0 0 0 0 0 0 0 0 0 0 0 0
2 0 0 0 0 0 0 0 0 0 2 2 0 0 0 2 2 0 0 0 0 0 0 2 2 2 0 0 0 1 0 0 0 1 1 1 2 2 1 1 1 1 1 0 0 0 0 2 2 2 2 0 0 0 0 0 0 0 0 0 2 2 0 0 0 0 0 0 0 0 0 0 0 0 2 0 0 0 0 0 0 0 0 0 0 0 0 0 0 0 0 0 0 0 0 0 0 0 0 0 0 0 0 0 0 0 0 0 0 0 0 0 0 0 0 0 0 0 0 0 0 0 0 0 0
2 0 0 0 0 0 0 0 0 0 2 2 2 0 2 2 2 0 0 2 2 0 0 2 2 2 0 0 0 0 0 0 0 0 0 0 2 2 0 0 0 0 0 0 0 0 0 2 2 2 2 0 0 0 0 0 0 0 0 0 2 2 0 0 0 0 0 0 0 0 0 0 0 0 2 0 0 0 0 0 0 0 0 0 0 0 0 0 0 0 0 0 0 0 0 0 0 0 0 0 0 0 0 0 0 0 0 0 0 0 0 0 0 0 0 0 0 0 0 0 0 0 0 0 0
1 1 0 0 0 0 0 0 0 0 2 2 2 2 2 2 2 0 0 2 2 0 0 1 1 1 1 2 2 2 2 2 0 0 0 0 2 2 0 0 0 0 0 0 0 0 0 2 2 2 2 0 1 1 2 1 1 1 0 0 1 2 0 0 0 0 0 2 2 2 2 0 0 0 2 0 0 0 0 0 0 0 0 0 0 0 0 0 0 0 0 0 0 0 0 0 0 0 0 0 0 0 0 0 0 0 0 0 0 0 0 0 0 0 0 0 0 0 0 0 0 0 0 0 0
0 0 0 0 2 1 1 1 0 0 1 1 1 1 1 1 1 0 0 2 2 0 0 0 0 0 0 2 2 2 2 2 0 0 0 0 2 2 0 0 0 0 0 0 0 0 0 2 2 2 2 0 0 0 2 0 0 0 0 0 0 1 0 0 0 0 0 1 1 1 1 0 0 0 2 0 0 0 0 0 0 0 0 0 0 0 0 0 0 0 0 0 0 0 0 0 0 0 0 0 0 0 0 0 0 0 0 0 0 0 0 0 0 0 0 0 0 0 0 0 0 0 0 0 0
0 0 0 0 2 0 0 0 0 0 1 0 0 0 0 0 0 0 0 2 2 0 0 0 0 0 0 1 0 0 0 2 2 2 0 0 2 2 0 0 0 0 0 0 0 0 0 2 2 2 2 0 0 0 2 0 0 0 0 0 0 0 0 0 0 0 0 0 0 0 0 0 0 0 2 0 0 0 0 0 0 0 0 0 0 0 0 0 0 0 0 0 0 0 0 0 0 0 0 0 0 0 0 0 0 0 0 0 0 0 0 0 0 0 0 0 0 0 0 0 0 0 0 0 0
2 0 0 0 2 0 0 0 0 0 0 0 0 0 0 0 0 0 0 2 2 0 0 0 2 2 0 0 0 0 0 1 1 1 0 0 2 2 0 0 0 0 1 1 1 1 1 2 2 2 2 0 0 0 2 0 0 0 0 0 0 0 0 0 0 0 0 0 0 0 0 0 2 2 2 0 0 0 0 0 0 0 0 0 0 0 0 0 0 0 0 0 0 0 0 0 0 0 0 0 0 0 0 0 0 0 0 0 0 0 0 0 0 0 0 0 0 0 0 0 0 0 0 0 0
2 0 0 0 2 0 0 0 0 0 0 2 2 2 0 0 0 0 0 2 2 0 0 0 2 2 0 0 0 0 0 0 0 0 0 0 2 2 0 0 0 0 0 0 0 0 0 1 1 1 1 1 0 0 2 0 0 0 0 0 0 0 0 0 0 0 0 0 0 0 0 0 1 1 2 0 0 0 0 0 0 0 0 0 0 0 0 0 0 0 0 0 0 0 0 0 0 0 0 0 0 0 0 0 0 0 0 0 0 0 0 0 0 0 0 0 0 0 0 0 0 0 0 0 0
2 0 0 0 2 0 0 0 0 0 0 2 2 2 0 0 0 0 0 2 2 0 0 0 2 2 0 0 0 0 0 0 0 0 0 0 2 2 0 0 0 0 0 0 0 0 0 0 0 0 0 0 0 0 2 0 0 0 0 0 0 0 0 0 0 0 0 0 0 0 0 0 0 0 2 0 0 0 0 0 0 0 0 0 0 0 0 0 0 0 0 0 0 0 0 0 0 0 0 0 0 0 0 0 0 0 0 0 0 0 0 0 0 0 0 0 0 0 0 0 0 0 0 0 0
2 0 0 0 2 0 0 0 0 0 2 2 2 2 0 0 0 0 0 2 2 0 0 0 2 2 0 0 0 0 0 0 0 0 0 0 2 2 0 0 0 0 0 0 0 0 0 0 0 0 0 0 0 0 2 0 0 0 0 0 0 0 0 0 0 0 0 0 0 0 0 0 0 0 2 0 0 0 0 0 0 0 0 0 0 0 0 0 0 0 0 0 0 0 0 0 0 0 0 0 0 0 0 0 0 0 0 0 0 0 0 0 0 0 0 0 0 0 0 0 0 0 0 0 0
2 2 2 2 2 2 2 2 2 2 2 2 2 2 2 2 2 2 2 2 2 2 2 2 2 2 2 2 2 2 2 2 2 2 2 2 2 2 2 2 2 2 2 2 2 2 2 2 2 2 2 2 2 2 2 2 2 2 2 2 2 2 2 2 2 2 2 2 2 2 2 2 0 0 2 0 0 0 0 0 0 0 0 0 0 0 0 0 0 0 0 0 2 2 2 0 0 0 0 0 0 0 0 0 0 0 0 0 0 0 0 0 0 0 0 0 0 0 0 0 0 0 0 0 0
2 1 1 1 2 2 2 2 2 2 2 1 2 2 2 2 2 2 1 1 1 2 2 2 2 2 2 2 2 2 2 2 2 1 1 1 2 2 1 1 1 1 2 2 2 2 2 2 2 2 2 1 1 1 1 1 1 2 2 2 2 2 2 1 1 1 1 1 2 1 1 1 0 0 2 2 2 1 1 1 2 1 1 1 1 1 1 1 1 1 2 2 2 2 2 2 2 2 2 2 0 0 0 0 0 0 0 0 0 0 0 0 0 0 0 0 0 0 0 0 0 0 0 0 0
2 2 2 2 2 2 2 2 2 2 2 0 1 2 2 2 2 2 2 2 2 2 2 2 2 2 2 2 2 2 2 2 2 0 0 0 2 2 2 0 0 0 2 2 2 2 2 2 2 2 2 0 0 0 0 0 2 2 2 2 2 2 2 0 0 0 0 0 2 0 0 0 0 0 2 2 2 2 2 2 2 0 0 0 0 0 0 0 0 0 2 2 2 2 2 2 2 2 2 2 0 0 0 0 0 0 0 0 0 0 0 0 0 0 0 0 0 0 0 0 0 0 0 0 0
2 0 0 0 2 2 2 2 2 2 2 0 0 0 0 0 0 1 0 0 0 2 2 2 2 2 2 2 2 2 2 2 2 0 0 0 2 2 2 0 0 0 2 2 2 2 2 2 2 2 2 0 0 0 0 0 2 2 2 0 0 0 1 0 0 0 0 0 2 0 0 0 0 0 2 2 2 0 0 0 2 0 0 0 0 0 0 0 0 0 2 0 0 0 2 2 2 2 2 2 0 0 0 0 0 0 0 0 0 0 0 0 0 0 0 0 0 0 0 0 0 0 0 0 0
2 0 0 0 1 2 2 2 2 2 2 0 0 0 0 0 0 0 0 0 0 1 2 2 2 2 2 2 2 2 2 2 2 0 0 0 2 2 2 0 0 0 1 2 2 2 2 2 2 2 2 0 2 0 0 0 2 2 2 0 0 0 0 0 0 0 0 0 2 0 0 0 0 0 2 2 2 0 0 0 2 0 0 0 0 0 0 0 0 0 2 0 0 0 2 2 2 2 2 2 0 0 0 0 0 0 0 0 0 0 0 0 0 0 0 0 0 0 0 0 0 0 0 0 0
2 0 0 0 0 1 2 2 2 2 2 0 0 0 0 0 0 0 0 0 0 0 1 2 2 2 1 1 0 0 0 0 1 0 0 0 2 2 2 0 0 0 0 0 0 0 0 0 1 1 2 0 2 0 0 0 1 2 2 0 0 0 0 0 0 0 0 0 2 0 0 0 0 0 2 2 2 0 0 0 2 0 0 0 0 0 0 0 0 0 2 0 0 0 2 2 2 2 2 2 0 0 0 0 0 0 0 0 0 0 0 0 0 0 0 0 0 0 0 0 0 0 0 0 0
2 0 0 0 0 0 1 2 2 2 2 0 0 1 1 1 1 1 0 0 0 0 0 1 2 2 0 0 0 0 0 0 0 0 0 0 2 2 2 0 0 0 0 0 0 0 0 0 0 0 2 0 1 0 0 0 0 1 2 0 0 0 0 0 0 0 0 0 1 0 0 0 0 0 2 2 2 0 0 0 2 0 0 2 0 0 0 2 0 0 2 0 0 0 2 2 2 2 2 2 0 0 0 0 0 0 0 0 0 0 0 0 0 0 0 0 0 0 0 0 0 0 0 0 0
2 0 0 0 0 0 0 1 2 1 1 0 0 0 0 0 0 0 0 0 0 0 0 0 2 2 0 0 0 0 0 0 0 0 0 0 1 2 2 0 0 0 0 0 0 0 0 0 0 0 2 0 0 0 0 0 0 0 1 0 0 0 0 0 2 2 0 0 0 0 0 1 1 1 2 2 2 0 0 0 1 0 0 2 0 0 0 2 0 0 1 0 0 0 2 2 2 2 2 2 0 0 0 0 0 0 0 0 0 0 0 0 0 0 0 0 0 0 0 0 0 0 0 0 0
2 0 0 0 0 0 0 0 1 0 0 0 0 0 0 0 1 1 2 1 1 0 0 0 2 2 0 0 0 0 0 0 0 0 0 0 0 1 2 0 0 1 1 1 2 1 1 0 0 0 2 0 0 0 0 0 0 0 0 0 0 0 0 0 2 2 0 0 0 0 0 0 0 0 2 2 2 0 0 0 0 0 0 1 0 0 0 1 0 0 0 0 0 0 2 2 2 2 2 2 0 0 0 0 0 0 0 0 0 0 0 0 0 0 0 0 0 0 0 0 0 0 0 0 0
2 0 0 0 0 0 0 0 0 0 0 0 0 0 0 0 0 0 2 0 0 0 0 0 2 2 0 0 0 0 0 0 0 0 0 0 0 0 1 0 0 0 0 0 2 0 0 0 0 0 2 0 2 0 0 0 0 0 0 0 0 0 0 0 2 2 0 0 0 0 0 0 0 0 2 2 2 0 0 0 0 0 0 0 0 0 0 0 0 0 0 0 0 0 2 2 2 2 2 2 0 0 0 0 0 0 0 0 0 0 0 0 0 0 0 0 0 0 0 0 0 0 0 0 0
2 0 0 0 0 0 0 0 0 0 0 0 0 0 0 0 0 0 2 0 0 0 0 0 2 2 0 0 0 0 0 0 0 0 0 0 0 0 0 0 0 0 0 0 2 0 0 0 0 0 2 0 2 0 0 0 0 0 0 0 0 0 0 0 2 2 0 0 0 0 0 0 0 0 2 2 2 0 0 0 0 0 0 0 0 0 0 0 0 0 0 0 0 0 2 1 1 1 2 2 0 0 0 0 0 0 0 0 0 0 0 0 0 0 0 0 0 0 0 0 0 0 0 0 0
2 0 0 0 0 0 0 0 0 0 0 0 0 0 0 0 0 0 2 0 0 0 0 1 1 1 0 0 0 0 0 0 0 0 0 0 0 0 0 0 0 0 0 0 2 0 0 0 1 1 1 0 2 0 0 0 0 0 0 0 0 0 0 0 2 2 0 0 0 0 0 0 0 0 2 2 2 0 0 0 0 0 0 0 0 0 0 0 0 0 0 0 0 0 1 0 0 0 2 2 0 0 0 0 0 0 0 0 0 0 0 0 0 0 0 0 0 0 0 0 0 0 0 0 0
2 0 0 0 0 0 0 0 0 0 0 0 0 0 0 0 0 0 2 0 0 0 0 0 0 0 0 0 0 0 0 0 0 0 0 0 0 0 0 0 0 0 0 0 2 0 0 0 0 0 0 0 2 0 0 0 0 0 0 0 0 0 0 0 2 2 0 0 0 0 0 0 0 0 2 2 2 0 0 0 0 0 0 0 0 0 0 0 0 0 0 0 0 0 0 0 0 0 2 2 0 0 0 0 0 0 0 0 0 0 0 0 0 0 0 0 0 0 0 0 0 0 0 0 0
2 0 0 0 0 0 0 0 0 0 0 0 0 0 0 0 0 0 2 0 0 0 0 0 0 0 0 0 0 0 0 0 0 0 0 0 0 0 0 0 0 0 0 0 2 0 0 0 0 0 0 0 2 0 0 0 0 0 0 0 0 0 0 0 2 2 0 0 0 0 0 0 0 0 2 2 2 0 0 0 0 0 0 0 0 0 0 0 0 0 0 0 0 0 0 0 0 0 2 2 0 0 0 0 0 0 0 0 0 0 0 0 0 0 0 0 0 0 0 0 0 0 0 0 0
2 0 0 2 2 2 2 2 2 2 2 2 2 2 2 2 2 2 2 2 2 2 2 2 2 2 2 2 2 2 2 2 2 2 2 2 2 2 2 2 2 2 2 2 2 2 2 2 2 2 2 2 2 2 2 2 2 2 2 2 2 2 2 2 2 2 2 2 2 2 2 2 2 2 2 2 2 2 2 2 2 2 2 2 2 2 2 2 2 2 2 2 2 2 2 2 0 0 2 2 0 0 0 0 0 0 0 0 0 0 0 0 0 0 0 0 0 0 0 0 0 0 0 0 0
2 0 0 1 2 2 2 2 1 1 1 1 1 1 1 1 1 1 1 1 1 1 1 1 2 2 1 1 1 1 1 1 1 1 1 1 1 1 1 1 1 1 1 1 1 2 2 1 1 2 2 1 1 1 1 1 1 1 2 1 1 1 1 1 1 1 2 2 1 1 1 1 1 1 2 2 2 2 2 2 2 2 2 1 2 2 2 2 2 2 2 2 2 2 2 2 0 0 1 2 0 0 0 0 0 0 0 0 0 0 0 0 0 0 0 0 0 0 0 0 0 0 0 0 0
2 0 0 0 2 2 2 2 2 2 2 2 2 2 2 2 2 2 2 2 2 2 2 2 2 2 0 0 0 0 0 0 0 0 0 0 0 0 0 0 0 0 0 0 0 2 2 2 2 2 2 0 0 0 0 0 0 0 2 0 0 0 0 0 0 0 1 2 0 0 0 0 0 0 1 1 1 1 2 2 2 2 1 0 0 0 0 0 0 0 0 0 2 0 0 2 0 0 0 2 0 0 0 0 0 0 0 0 0 0 0 0 0 0 0 0 0 0 0 0 0 0 0 0 0
2 0 0 0 2 2 1 1 0 0 0 0 0 0 0 0 0 0 0 0 0 0 0 0 2 2 0 0 0 0 0 0 0 0 0 0 0 0 0 0 0 0 0 0 0 2 2 0 0 1 1 0 0 0 0 0 0 0 2 0 0 0 0 0 0 0 0 1 0 0 0 0 0 0 0 0 0 0 0 0 0 0 0 0 0 0 0 0 0 0 0 0 2 0 0 2 0 0 0 2 0 0 0 0 0 0 0 0 0 0 0 0 0 0 0 0 0 0 0 0 0 0 0 0 0
2 0 0 0 2 2 0 0 0 0 0 0 2 0 0 0 0 0 0 0 0 0 0 0 2 2 0 0 0 0 0 0 1 1 1 1 2 0 0 0 0 0 0 0 0 2 2 0 0 0 0 0 0 0 2 1 0 0 1 0 0 0 0 0 0 0 0 0 0 0 0 0 0 0 0 0 0 0 0 0 0 0 0 0 0 0 0 0 2 0 0 0 2 0 0 2 0 0 0 2 0 0 0 0 0 0 0 0 0 0 0 0 0 0 0 0 0 0 0 0 0 0 0 0 0
2 0 0 0 2 2 0 0 0 0 0 0 2 0 0 0 0 2 0 0 0 0 0 0 2 2 0 0 0 0 0 0 0 0 0 0 2 0 0 0 0 0 0 0 0 2 2 0 0 0 0 0 0 0 2 0 0 0 0 0 0 0 0 0 0 0 0 0 0 0 0 2 0 0 2 2 2 1 1 1 1 1 1 1 1 1 0 0 2 2 0 0 2 0 0 2 0 0 0 2 0 0 0 0 0 0 0 0 0 0 0 0 0 0 0 0 0 0 0 0 0 0 0 0 0
2 1 1 0 2 2 0 0 0 0 0 0 1 0 0 0 0 2 0 0 0 0 0 0 2 2 0 0 0 0 0 0 0 0 0 0 2 2 2 2 1 0 0 0 0 2 2 0 0 2 2 0 0 0 2 0 0 0 0 0 0 0 0 0 0 0 0 0 0 0 0 2 0 0 2 2 2 0 0 0 0 0 0 0 0 0 0 0 1 2 0 0 2 0 0 2 0 0 0 2 0 0 0 0 0 0 0 0 0 0 0 0 0 0 0 0 0 0 0 0 0 0 0 0 0
2 0 0 0 2 2 0 0 0 0 0 0 0 0 0 0 0 1 0 0 0 1 1 1 1 1 1 1 2 2 2 2 2 2 0 0 2 2 1 1 0 0 0 0 0 2 2 0 0 2 2 0 0 0 2 2 2 2 2 2 2 2 2 2 2 2 2 2 2 2 2 2 2 2 2 2 2 0 0 0 0 0 0 0 0 0 0 0 0 1 0 0 2 0 0 2 0 0 0 2 0 0 0 0 0 0 0 0 0 0 0 0 0 0 0 0 0 0 0 0 0 0 0 0 0
2 0 0 0 2 2 0 0 0 1 0 0 0 0 2 0 0 0 0 0 0 0 0 0 0 0 0 0 2 2 2 2 2 2 0 0 2 2 0 0 0 0 0 0 0 2 2 0 0 2 2 0 0 0 2 2 2 2 2 2 2 2 2 2 2 2 2 2 2 2 2 2 2 1 1 1 1 1 1 2 2 2 2 2 2 1 0 0 0 0 0 1 2 0 0 2 0 0 0 2 0 0 0 0 0 0 0 0 0 0 0 0 0 0 0 0 0 0 0 0 0 0 0 0 0
2 0 0 0 1 1 0 2 0 0 0 0 0 0 2 0 0 0 0 0 0 0 0 0 0 0 0 0 1 1 0 0 1 1 0 0 2 2 0 0 0 0 0 0 0 2 2 0 0 2 2 0 0 0 1 0 0 0 0 1 0 0 0 0 0 1 0 0 0 0 0 0 0 0 0 0 0 0 1 2 2 2 2 2 2 0 0 0 0 0 0 0 2 0 0 2 0 0 0 2 0 0 0 0 0 0 0 0 0 0 0 0 0 0 0 0 0 0 0 0 0 0 0 0 0
2 0 0 0 0 0 0 2 0 0 0 0 0 0 1 0 0 0 0 0 0 0 0 0 2 0 0 0 0 0 0 0 0 0 0 0 2 2 0 0 0 1 1 1 1 2 2 0 0 2 2 0 0 0 0 0 0 0 0 0 0 0 0 0 0 0 0 0 0 0 0 0 0 0 0 0 0 0 0 1 2 2 2 2 2 0 0 0 0 0 0 0 1 1 1 1 0 0 0 2 0 0 0 0 0 0 0 0 0 0 0 0 0 0 0 0 0 0 0 0 0 0 0 0 0
2 0 0 0 0 0 0 2 0 0 0 0 0 0 0 0 0 0 0 0 0 0 0 0 2 2 0 0 0 0 0 0 0 0 0 0 2 2 0 0 0 0 0 0 0 1 1 0 0 2 2 0 0 0 0 2 0 0 0 0 0 0 0 0 0 0 0 0 0 0 0 0 0 0 2 2 0 0 0 0 1 1 1 1 1 0 0 0 0 0 0 0 0 0 0 0 0 0 0 2 0 0 0 0 0 0 0 0 0 0 0 0 0 0 0 0 0 0 0 0 0 0 0 0 0
2 0 0 0 0 0 0 2 0 0 0 0 0 0 0 0 0 0 0 0 0 0 0 0 2 2 0 0 0 0 0 0 0 0 0 0 2 2 0 0 0 0 0 0 0 0 0 0 0 2 2 0 0 0 0 2 0 0 0 0 2 0 0 0 0 0 0 0 2 0 0 0 0 0 2 2 0 0 0 0 0 0 0 0 0 0 0 0 0 0 0 0 0 0 0 0 0 0 0 2 0 0 0 0 0 0 0 0 0 0 0 0 0 0 0 0 0 0 0 0 0 0 0 0 0
2 0 0 0 0 0 0 2 0 0 0 0 0 0 0 0 0 0 0 0 0 0 0 0 2 2 0 0 0 0 0 0 0 0 0 0 2 2 0 0 0 0 0 0 0 0 0 0 0 2 2 0 0 0 0 2 0 0 0 0 2 0 0 0 0 0 0 0 2 0 0 0 0 0 2 2 0 0 0 0 0 0 0 0 0 0 0 0 0 0 0 0 0 0 0 0 0 0 0 2 0 0 0 0 0 0 0 0 0 0 0 0 0 0 0 0 0 0 0 0 0 0 0 0 0
2 2 2 2 2 2 2 2 2 2 2 2 2 2 2 2 2 2 2 2 2 2 2 2 2 2 2 2 2 2 2 2 2 2 2 2 2 2 2 2 2 2 2 2 2 2 2 2 2 2 2 2 2 2 2 2 2 2 2 2 2 2 2 2 2 2 2 2 2 2 2 2 2 2 2 2 2 2 2 2 2 2 2 2 2 2 2 2 2 2 2 2 2 2 2 2 2 2 2 2 0 0 0 0 0 0 0 0 0 0 0 0 0 0 0 0 0 0 0 0 0 0 0 0 0
0 0 0 0 0 0 0 0 0 0 0 0 0 0 0 0 0 0 0 0 0 0 0 0 0 0 0 0 0 0 0 0 0 0 0 0 0 0 0 0 0 0 0 0 0 0 0 0 0 0 0 0 0 0 0 0 0 0 0 0 0 0 0 0 0 0 0 0 0 0 0 0 0 0 0 0 0 0 0 0 0 0 0 0 0 0 0 0 0 0 0 0 0 0 0 0 0 0 0 0 0 0 0 0 0 0 0 0 0 0 0 0 0 0 0 0 0 0 0 0 0 0 0 0 0
0 0 0 0 0 0 0 0 0 0 0 0 0 0 0 0 0 0 0 0 0 0 0 0 0 0 0 0 0 0 0 0 0 0 0 0 0 0 0 0 0 0 0 0 0 0 0 0 0 0 0 0 0 0 0 0 0 0 0 0 0 0 0 0 0 0 0 0 0 0 0 0 0 0 0 0 0 0 0 0 0 0 0 0 0 0 0 0 0 0 0 0 0 0 0 0 0 0 0 0 0 0 0 0 0 0 0 0 0 0 0 0 0 0 0 0 0 0 0 0 0 0 0 0 0
0 0 0 0 0 0 0 0 0 0 0 0 0 0 0 0 0 0 0 0 0 0 0 0 0 0 0 0 0 0 0 0 0 0 0 0 0 0 0 0 0 0 0 0 0 0 0 0 0 0 0 0 0 0 0 0 0 0 0 0 0 0 0 0 0 0 0 0 0 0 0 0 0 0 0 0 0 0 0 0 0 0 0 0 0 0 0 0 0 0 0 0 0 0 0 0 0 0 0 0 0 0 0 0 0 0 0 0 0 0 0 0 0 0 0 0 0 0 0 0 0 0 0 0 0
0 0 0 0 0 0 0 0 0 0 0 0 0 0 0 0 0 0 0 0 0 0 0 0 0 0 0 0 0 0 0 0 0 0 0 0 0 0 0 0 0 0 0 0 0 0 0 0 0 0 0 0 0 0 0 0 0 0 0 0 0 0 0 0 0 0 0 0 0 0 0 0 0 0 0 0 0 0 0 0 0 0 0 0 0 0 0 0 0 0 0 0 0 0 0 0 0 0 0 0 0 0 0 0 0 0 0 0 0 0 0 0 0 0 0 0 0 0 0 0 0 0 0 0 0
0 0 0 0 0 0 0 0 0 0 0 0 0 0 0 0 0 0 0 0 0 0 0 0 0 0 0 0 0 0 0 0 0 0 0 0 0 0 0 0 0 0 0 0 0 0 0 0 0 0 0 0 0 0 0 0 0 0 0 0 0 0 0 0 0 0 0 0 0 0 0 0 0 0 0 0 0 0 0 0 0 0 0 0 0 0 0 0 0 0 0 0 0 0 0 0 0 0 0 0 0 0 0 0 0 0 0 0 0 0 0 0 0 0 0 0 0 0 0 0 0 0 0 0 0
0 0 0 0 0 0 0 0 0 0 0 0 0 0 0 0 0 0 0 0 0 0 0 0 0 0 0 0 0 0 0 0 0 0 0 0 0 0 0 0 0 0 0 0 0 0 0 0 0 0 0 0 0 0 0 0 0 0 0 0 0 0 0 0 0 0 0 0 0 0 0 0 0 0 0 0 0 0 0 0 0 0 0 0 0 0 0 0 0 0 0 0 0 0 0 0 0 0 0 0 0 0 0 0 0 0 0 0 0 0 0 0 0 0 0 0 0 0 0 0 0 0 0 0 0
0 0 0 0 0 0 0 0 0 0 0 0 0 0 0 0 0 0 0 0 0 0 0 0 0 0 0 0 0 0 0 0 0 0 0 0 0 0 0 0 0 0 0 0 0 0 0 0 0 0 0 0 0 0 0 0 0 0 0 0 0 0 0 0 0 0 0 0 0 0 0 0 0 0 0 0 0 0 0 0 0 0 0 0 0 0 0 0 0 0 0 0 0 0 0 0 0 0 0 0 0 0 0 0 0 0 0 0 0 0 0 0 0 0 0 0 0 0 0 0 0 0 0 0 0
0 0 0 0 0 0 0 0 0 0 0 0 0 0 0 0 0 0 0 0 0 0 0 0 0 0 0 0 0 0 0 0 0 0 0 0 0 0 0 0 0 0 0 0 0 0 0 0 0 0 0 0 0 0 0 0 0 0 0 0 0 0 0 0 0 0 0 0 0 0 0 0 0 0 0 0 0 0 0 0 0 0 0 0 0 0 0 0 0 0 0 0 0 0 0 0 0 0 0 0 0 0 0 0 0 0 0 0 0 0 0 0 0 0 0 0 0 0 0 0 0 0 0 0 0
0 0 0 0 0 0 0 0 0 0 0 0 0 0 0 0 0 0 0 0 0 0 0 0 0 0 0 0 0 0 0 0 0 0 0 0 0 0 0 0 0 0 0 0 0 0 0 0 0 0 0 0 0 0 0 0 0 0 0 0 0 0 0 0 0 0 0 0 0 0 0 0 0 0 0 0 0 0 0 0 0 0 0 0 0 0 0 0 0 0 0 0 0 0 0 0 0 0 0 0 0 0 0 0 0 0 0 0 0 0 0 0 0 0 0 0 0 0 0 0 0 0 0 0 0
0 0 0 0 0 0 0 0 0 0 0 0 0 0 0 0 0 0 0 0 0 0 0 0 0 0 0 0 0 0 0 0 0 0 0 0 0 0 0 0 0 0 0 0 0 0 0 0 0 0 0 0 0 0 0 0 0 0 0 0 0 0 0 0 0 0 0 0 0 0 0 0 0 0 0 0 0 0 0 0 0 0 0 0 0 0 0 0 0 0 0 0 0 0 0 0 0 0 0 0 0 0 0 0 0 0 0 0 0 0 0 0 0 0 0 0 0 0 0 0 0 0 0 0 0
0 0 0 0 0 0 0 0 0 0 0 0 0 0 0 0 0 0 0 0 0 0 0 0 0 0 0 0 0 0 0 0 0 0 0 0 0 0 0 0 0 0 0 0 0 0 0 0 0 0 0 0 0 0 0 0 0 0 0 0 0 0 0 0 0 0 0 0 0 0 0 0 0 0 0 0 0 0 0 0 0 0 0 0 0 0 0 0 0 0 0 0 0 0 0 0 0 0 0 0 0 0 0 0 0 0 0 0 0 0 0 0 0 0 0 0 0 0 0 0 0 0 0 0 0
0 0 0 0 0 0 0 0 0 0 0 0 0 0 0 0 0 0 0 0 0 0 0 0 0 0 0 0 0 0 0 0 0 0 0 0 0 0 0 0 0 0 0 0 0 0 0 0 0 0 0 0 0 0 0 0 0 0 0 0 0 0 0 0 0 0 0 0 0 0 0 0 0 0 0 0 0 0 0 0 0 0 0 0 0 0 0 0 0 0 0 0 0 0 0 0 0 0 0 0 0 0 0 0 0 0 0 0 0 0 0 0 0 0 0 0 0 0 0 0 0 0 0 0 0
0 0 0 0 0 0 0 0 0 0 0 0 0 0 0 0 0 0 0 0 0 0 0 0 0 0 0 0 0 0 0 0 0 0 0 0 0 0 0 0 0 0 0 0 0 0 0 0 0 0 0 0 0 0 0 0 0 0 0 0 0 0 0 0 0 0 0 0 0 0 0 0 0 0 0 0 0 0 0 0 0 0 0 0 0 0 0 0 0 0 0 0 0 0 0 0 0 0 0 0 0 0 0 0 0 0 0 0 0 0 0 0 0 0 0 0 0 0 0 0 0 0 0 0 0
0 0 0 0 0 0 0 0 0 0 0 0 0 0 0 0 0 0 0 0 0 0 0 0 0 0 0 0 0 0 0 0 0 0 0 0 0 0 0 0 0 0 0 0 0 0 0 0 0 0 0 0 0 0 0 0 0 0 0 0 0 0 0 0 0 0 0 0 0 0 0 0 0 0 0 0 0 0 0 0 0 0 0 0 0 0 0 0 0 0 0 0 0 0 0 0 0 0 0 0 0 0 0 0 0 0 0 0 0 0 0 0 0 0 0 0 0 0 0 0 0 0 0 0 0
traps 163
trap lavapool 8.5 1.5 1 1 id 10 dpt 10 tick 0.2
trap lavapool 9.5 1.5 1 1 id 33 dpt 10 tick 0.2
trap pressureplate 10.5 8.5 1 1 id 43 links 3 52 60 81
trap spikeplate 12.5 8.5 1 1 id 52 up 1 down 1 dmg 10 startDisabled 1
trap spikeplate 11.5 8.5 1 1 id 60 up 1 down 1 dmg 10 startDisabled 1
trap spikeplate 13.5 8.5 1 1 id 81 up 1 down 1 dmg 10 startDisabled 1
trap lavapool 28.5 7.5 1 1 id 365 dpt 10 tick 0.2
trap lavapool 29.5 7.5 1 1 id 378 dpt 10 tick 0.2
trap lavapool 30.5 7.5 1 1 id 400 dpt 10 tick 0.2
trap lavapool 26.5 1.5 1 1 id 416 dpt 10 tick 0.2
trap lavapool 27.5 1.5 1 1 id 426 dpt 10 tick 0.2
trap lavapool 28.5 1.5 1 1 id 442 dpt 10 tick 0.2
trap spikeplate 39.5 5.5 1 1 id 487 up 1 down 1 dmg 10 startDisabled 1
trap spikeplate 40.5 5.5 1 1 id 498 up 1 down 1 dmg 10 startDisabled 1
trap lavapool 56.5 1.5 1 1 id 659 dpt 10 tick 0.2
trap lavapool 57.5 1.5 1 1 id 664 dpt 10 tick 0.2
trap lavapool 58.5 1.5 1 1 id 675 dpt 10 tick 0.2
trap lavapool 62.5 1.5 1 1 id 702 dpt 10 tick 0.2
trap lavapool 63.5 1.5 1 1 id 712 dpt 10 tick 0.2
trap lavapool 64.5 1.5 1 1 id 749 dpt 10 tick 0.2
trap spikeplate 68.5 20.5 1 1 id 774 up 1 down 1 dmg 10 startDisabled 1
trap lavapool 59.5 15.5 1 1 id 859 dpt 10 tick 0.2
trap lavapool 60.5 15.5 1 1 id 875 dpt 10 tick 0.2
trap lavapool 61.5 15.5 1 1 id 902 dpt 10 tick 0.2
trap spikeplate 58.5 21.5 1 1 id 945 up 1 down 1 dmg 10 startDisabled 1
trap spikeplate 57.5 20.5 1 1 id 952 up 1 down 1 dmg 10 startDisabled 1
trap spikeplate 56.5 19.5 1 1 id 967 up 1 down 1 dmg 10 startDisabled 1
trap lavapool 47.5 17.5 1 1 id 986 dpt 10 tick 0.2
trap lavapool 46.5 17.5 1 1 id 998 dpt 10 tick 0.2
trap lavapool 45.5 17.5 1 1 id 1012 dpt 10 tick 0.2
trap lavapool 44.5 17.5 1 1 id 1019 dpt 10 tick 0.2
trap lavapool 43.5 17.5 1 1 id 1136 dpt 10 tick 0.2
trap spikeplate 36.5 21.5 1 1 id 1175 up 1 down 1 dmg 10 startDisabled 1
trap spikeplate 37.5 22.5 1 1 id 1183 up 1 down 1 dmg 10 startDisabled 1
trap spikeplate 38.5 23.5 1 1 id 1198 up 1 down 1 dmg 10 startDisabled 1
trap lavapool 31.5 17.5 1 1 id 1211 dpt 10 tick 0.2
trap lavapool 30.5 17.5 1 1 id 1217 dpt 10 tick 0.2
trap lavapool 29.5 17.5 1 1 id 1223 dpt 10 tick 0.2
trap lavapool 28.5 17.5 1 1 id 1231 dpt 10 tick 0.2
trap spikeplate 23.5 20.5 1 1 id 1876 up 1 down 1 dmg 10 startDisabled 1
trap spikeplate 22.5 19.5 1 1 id 1884 up 1 down 1 dmg 10 startDisabled 1
trap spikeplate 21.5 18.5 1 1 id 1895 up 1 down 1 dmg 10 startDisabled 1
trap lavapool 14.5 15.5 1 1 id 1931 dpt 10 tick 0.2
trap lavapool 15.5 15.5 1 1 id 1941 dpt 10 tick 0.2
trap lavapool 16.5 15.5 1 1 id 1957 dpt 10 tick 0.2
trap lavapool 18.5 15.5 1 1 id 2023 dpt 10 tick 0.2
trap lavapool 19.5 15.5 1 1 id 2029 dpt 10 tick 0.2
trap lavapool 20.5 15.5 1 1 id 2047 dpt 10 tick 0.2
trap lavapool 13.5 15.5 1 1 id 2069 dpt 10 tick 0.2
trap lavapool 1.5 15.5 1 1 id 2190 dpt 10 tick 0.2
trap lavapool 2.5 15.5 1 1 id 2198 dpt 10 tick 0.2
trap lavapool 3.5 15.5 1 1 id 2222 dpt 10 tick 0.2
trap pressureplate 5.5 36.5 1 1 id 2233 links 4 2434 2442 2452 2474
trap lavapool 8.5 29.5 1 1 id 2290 dpt 10 tick 0.2
trap lavapool 9.5 29.5 1 1 id 2293 dpt 10 tick 0.2
trap lavapool 10.5 29.5 1 1 id 2299 dpt 10 tick 0.2
trap lavapool 11.5 29.5 1 1 id 2304 dpt 10 tick 0.2
trap lavapool 12.5 29.5 1 1 id 2307 dpt 10 tick 0.2
trap lavapool 13.5 29.5 1 1 id 2310 dpt 10 tick 0.2
trap lavapool 14.5 29.5 1 1 id 2313 dpt 10 tick 0.2
trap lavapool 15.5 29.5 1 1 id 2318 dpt 10 tick 0.2
trap lavapool 16.5 29.5 1 1 id 2324 dpt 10 tick 0.2
trap lavapool 17.5 29.5 1 1 id 2330 dpt 10 tick 0.2
trap lavapool 18.5 29.5 1 1 id 2336 dpt 10 tick 0.2
trap lavapool 19.5 29.5 1 1 id 2348 dpt 10 tick 0.2
trap lavapool 20.5 29.5 1 1 id 2359 dpt 10 tick 0.2
trap lavapool 21.5 29.5 1 1 id 2368 dpt 10 tick 0.2
trap lavapool 22.5 29.5 1 1 id 2383 dpt 10 tick 0.2
trap lavapool 23.5 29.5 1 1 id 2410 dpt 10 tick 0.2
trap spikeplate 9.5 36.5 1 1 id 2434 up 1 down 1 dmg 10 startDisabled 1
trap spikeplate 12.5 34.5 1 1 id 2442 up 1 down 1 dmg 10 startDisabled 1
trap spikeplate 14.5 38.5 1 1 id 2452 up 1 down 1 dmg 10 startDisabled 1
trap spikeplate 17.5 35.5 1 1 id 2474 up 1 down 1 dmg 10 startDisabled 1
trap lavapool 30.5 35.5 1 1 id 2524 dpt 10 tick 0.2
trap lavapool 31.5 35.5 1 1 id 2547 dpt 10 tick 0.2
trap pressureplate 33.5 31.5 1 1 id 2565 links 4 2574 2585 2594 2604
trap spikeplate 26.5 29.5 1 1 id 2574 up 1 down 1 dmg 10 startDisabled 1
trap spikeplate 27.5 29.5 1 1 id 2585 up 1 down 1 dmg 10 startDisabled 1
trap spikeplate 28.5 29.5 1 1 id 2594 up 1 down 1 dmg 10 startDisabled 1
trap spikeplate 29.5 29.5 1 1 id 2604 up 1 down 1 dmg 10 startDisabled 1
trap lavapool 47.5 29.5 1 1 id 2616 dpt 10 tick 0.2
trap lavapool 48.5 29.5 1 1 id 2678 dpt 10 tick 0.2
trap lavapool 59.5 1.5 1 1 id 2691 dpt 10 tick 0.2
trap spikeplate 60.5 7.5 1 1 id 2700 up 1 down 1 dmg 10 startDisabled 1
trap spikeplate 61.5 8.5 1 1 id 2707 up 1 down 1 dmg 10 startDisabled 1
trap pressureplate 53.5 6.5 1 1 id 2713 links 2 2700 2707
trap pressureplate 69.5 14.5 1 1 id 2718 links 4 774 945 952 967
trap pressureplate 30.5 0.5 1 1 id 2725 links 2 487 498
trap pressureplate 39.5 14.5 1 1 id 2731 links 3 1175 1183 1198
trap pressureplate 19.5 21.5 1 1 id 2741 links 3 1876 1884 1895
trap pressureplate 9.5 20.5 1 1 id 2748 links 5 2755 2763 2768 2775 2780
trap spikeplate 8.5 22.5 1 1 id 2755 up 1 down 1 dmg 10 startDisabled 1
trap spikeplate 7.5 21.5 1 1 id 2763 up 1 down 1 dmg 10 startDisabled 1
trap spikeplate 6.5 20.5 1 1 id 2768 up 1 down 1 dmg 10 startDisabled 1
trap spikeplate 5.5 19.5 1 1 id 2775 up 1 down 1 dmg 10 startDisabled 1
trap spikeplate 4.5 18.5 1 1 id 2780 up 1 down 1 dmg 10 startDisabled 1
trap lavapool 55.5 35.5 1 1 id 3116 dpt 10 tick 0.2
trap lavapool 56.5 35.5 1 1 id 3121 dpt 10 tick 0.2
trap lavapool 57.5 35.5 1 1 id 3145 dpt 10 tick 0.2
trap lavapool 58.5 35.5 1 1 id 3167 dpt 10 tick 0.2
trap lavapool 60.5 35.5 1 1 id 3174 dpt 10 tick 0.2
trap lavapool 61.5 35.5 1 1 id 3180 dpt 10 tick 0.2
trap lavapool 62.5 35.5 1 1 id 3187 dpt 10 tick 0.2
trap lavapool 63.5 35.5 1 1 id 3199 dpt 10 tick 0.2
trap lavapool 64.5 35.5 1 1 id 3223 dpt 10 tick 0.2
trap lavapool 66.5 35.5 1 1 id 3236 dpt 10 tick 0.2
trap lavapool 67.5 35.5 1 1 id 3239 dpt 10 tick 0.2
trap lavapool 68.5 35.5 1 1 id 3242 dpt 10 tick 0.2
trap lavapool 69.5 35.5 1 1 id 3245 dpt 10 tick 0.2
trap lavapool 70.5 35.5 1 1 id 3251 dpt 10 tick 0.2
trap lavapool 71.5 35.5 1 1 id 3280 dpt 10 tick 0.2
trap lavapool 72.5 35.5 1 1 id 3303 dpt 10 tick 0.2
trap pressureplate 58.5 31.5 1 1 id 3312 links 2 3329 3355
trap spikeplate 59.5 29.5 1 1 id 3329 up 1 down 1 dmg 10 startDisabled 1
trap spikeplate 61.5 29.5 1 1 id 3355 up 1 down 1 dmg 10 startDisabled 1
trap pressureplate 60.5 28.5 1 1 id 3485 links 1 3509
trap spikeplate 63.5 29.5 1 1 id 3509 up 1 down 1 dmg 10 startDisabled 1
trap pressureplate 64.5 28.5 1 1 id 3529 links 2 3665 3678
trap spikeplate 68.5 29.5 1 1 id 3578 up 1 down 1 dmg 10 startDisabled 1
trap spikeplate 69.5 29.5 1 1 id 3588 up 1 down 1 dmg 10 startDisabled 1
trap spikeplate 70.5 29.5 1 1 id 3599 up 1 down 1 dmg 10 startDisabled 1
trap spikeplate 71.5 29.5 1 1 id 3608 up 1 down 1 dmg 10 startDisabled 1
trap spikeplate 72.5 29.5 1 1 id 3618 up 1 down 1 dmg 10 startDisabled 1
trap spikeplate 73.5 29.5 1 1 id 3628 up 1 down 1 dmg 10 startDisabled 1
trap spikeplate 66.5 30.5 1 1 id 3665 up 1 down 1 dmg 10 startDisabled 1
trap spikeplate 65.5 29.5 1 1 id 3678 up 1 down 1 dmg 10 startDisabled 1
trap pressureplate 67.5 30.5 1 1 id 3687 links 3 3608 3618 3628
trap pressureplate 62.5 28.5 1 1 id 3693 links 3 3578 3588 3599
trap lavapool 78.5 29.5 1 1 id 3710 dpt 10 tick 0.2
trap lavapool 79.5 29.5 1 1 id 3719 dpt 10 tick 0.2
trap lavapool 80.5 29.5 1 1 id 3728 dpt 10 tick 0.2
trap lavapool 81.5 29.5 1 1 id 3745 dpt 10 tick 0.2
trap pressureplate 78.5 36.5 1 1 id 3771 links 5 3843 3864 3874 3893 3955
trap pressureplate 79.5 37.5 1 1 id 3788 links 5 3843 3864 3874 3893 3955
trap pressureplate 80.5 38.5 1 1 id 3828 links 5 3843 3864 3874 3893 3955
trap spikeplate 81.5 39.5 1 1 id 3843 up 1 down 1 dmg 10 startDisabled 1
trap spikeplate 82.5 39.5 1 1 id 3864 up 1 down 1 dmg 10 startDisabled 1
trap spikeplate 83.5 39.5 1 1 id 3874 up 1 down 1 dmg 10 startDisabled 1
trap spikeplate 84.5 39.5 1 1 id 3893 up 1 down 1 dmg 10 startDisabled 1
trap spikeplate 85.5 36.5 1 1 id 3955 up 1 down 1 dmg 10 startDisabled 1
trap spikeplate 88.5 34.5 1 1 id 3971 up 1 down 1 dmg 10 startDisabled 1
trap spikeplate 91.5 36.5 1 1 id 3981 up 1 down 1 dmg 10 startDisabled 1
trap spikeplate 89.5 35.5 1 1 id 3988 up 1 down 1 dmg 10 startDisabled 1
trap pressureplate 83.5 28.5 1 1 id 3994 links 3 3971 3981 3988
trap spikeplate 92.5 38.5 1 1 id 4002 up 1 down 1 dmg 10 startDisabled 1
trap spikeplate 93.5 38.5 1 1 id 4007 up 1 down 1 dmg 10 startDisabled 1
trap spikeplate 94.5 38.5 1 1 id 4026 up 1 down 1 dmg 10 startDisabled 1
trap spikeplate 95.5 38.5 1 1 id 4056 up 1 down 1 dmg 10 startDisabled 1
trap pressureplate 85.5 32.5 1 1 id 4067 links 4 4002 4007 4026 4056
trap spikeplate 80.5 21.5 1 1 id 4074 up 1 down 1 dmg 10 startDisabled 1
trap spikeplate 83.5 22.5 1 1 id 4091 up 1 down 1 dmg 10 startDisabled 1
trap spikeplate 87.5 22.5 1 1 id 4099 up 1 down 1 dmg 10 startDisabled 1
trap spikeplate 90.5 21.5 1 1 id 4106 up 1 down 1 dmg 10 startDisabled 1
trap pressureplate 88.5 14.5 1 1 id 4135 links 1 4106
trap pressureplate 86.5 14.5 1 1 id 4143 links 1 4099
trap pressureplate 83.5 14.5 1 1 id 4151 links 1 4091
trap pressureplate 81.5 14.5 1 1 id 4157 links 1 4074
trap lavapool 77.5 15.5 1 1 id 4276 dpt 10 tick 0.2
trap lavapool 78.5 15.5 1 1 id 4282 dpt 10 tick 0.2
trap lavapool 79.5 15.5 1 1 id 4305 dpt 10 tick 0.2
trap lavapool 91.5 15.5 1 1 id 5692 dpt 10 tick 0.2
trap lavapool 92.5 15.5 1 1 id 5705 dpt 10 tick 0.2
trap lavapool 93.5 15.5 1 1 id 5733 dpt 10 tick 0.2
enemies 27
enemy skeleton 5.5 8
enemy skeleton 17.5 1
enemy skeleton 19.5 1
enemy skeleton 34.5 5
enemy skeleton 41.5 5
enemy skeleton 55.5 7
enemy skeleton 72.5 21
enemy skeleton 65.5 15
enemy skeleton 67.5 15
enemy skeleton 55.5 15
enemy skeleton 53.5 15
enemy skeleton 35.5 15
enemy skeleton 33.5 15
enemy druid 15.5 20
enemy druid 17.5 22
enemy druid 7.5 31
enemy skeleton 1.5 34
enemy skeleton 29.5 37
enemy skeleton 32.5 37
enemy druid 38.5 35
enemy druid 42.5 38
enemy druid 82.5 33
enemy druid 79.5 33
enemy skeleton 87.5 29
enemy skeleton 90.5 29
enemy boss 84.5 16
enemy druid 42.5 22
vines 0
